########################################
#   #   #   #   #     #   #   #     # ##
### ### ### # ### # ### # ### # ### # ##
# #   #   #     # # #   #     #   #   ##
# # # ### ##### # # # ########### ######
#   #             #         #   # #   ##
##### ############### ##### # # # # # ##
#   # #             #   #   # #   # # ##
# # # ############# ### # ### # ### # ##
# #   #   #       # #   #   # #     # ##
# ##### # ####### # # ##### # ####### ##
#     # #     #   #       # #   #     ##
### ### # ### # # ######### ### ### ####
#   #   #   #   # #           #   #   ##
# ### ### # ##### # ############# ### ##
#     #   # #   # #               #   ##
### ### ### # ### ################# # ##
#   #   #   #     #                 # F#
#I### ### #### #### # ##### ##### # # ##
########################################